0000000000000000000000
1000000000000000000000
1000000000000000000000
1000000000000000000000
1000000000000000000000
1000000000000000000000
1001000111111111001111
1011000111111111001111
1011100111111111001111
1111100111111111001111
1111000111111111001111