0000000000000000000000000000000000000000000000000000
0000000000000000000000000000000000000000000000000000
0000000000000000000000000000000000000000000000000000
0000000000000000000000000000000000000000000000000000
0000111000000000000000000000000000000000000000000000
0000000000110000000000000000000000000000000000000000
0000000000000000000000000000000000000000000000000000
0000000000000000000000000000000000000000000000000000
0000000000000011000000000000000000000000000000000000
0000000000E00000000000000000000000000000000000000000
0000000001100000000000000000000000000000000000000000
0000000000000000CCCCCCCCCCCC000000000000000000000000
0000000000000000CCCCCCCCCCCC0000000E0000000D00000000
0222222222222222222222222222222222222222222222200022
0111111111111111111111111111111111111111111111100011
0111111111111111111111111111111111111111111111100011
0111111111111111111111111111111111111111111111100011
0111111111111111111111111111111111111111111111100011
