00000000000000000000000000000000000000000001
00000000000000000000000000000000000000000001
00000000000000000000000000000000000000000001
00000000000000000000000000000000000000000001
00000000000000000000000000000000000000000001
00000000000000000000000000000000000000000001
00000000000000000000000000000000000000000001
000000000000CC000000E0000CC00000000000000001
0000000000001100000CC00001100000000000000001
0000000000CC000000011000000000CC000000000001
00000000001100000000000000000011000000000001
0000000000000000000CCCC000000000000000000001
00000000000000000000000000000E00000000000D01
02222222222222222222222222222222222222222222
01111111111111111111111111111111111111111111
01111111111111111111111111111111111111111111
01111111111111111111111111111111111111111111
01111111111111111111111111111111111111111111